1111111
1000001
1000201
1000001
1111111